11111111111111
10010000000C001
1000011111000001
1P0011E00000001
11111111111111
